abraham===abraham
amalec===amalec
amalecite===amalecite
amalécite===amalécite
aman===aman
asaph===asaph
asie===asie
assuérus===assuérus
assyriens===assyriens
benjamin===benjamin
chaldée===chaldée
chaldéens===chaldéens
cyrus===cyrus
david===david
égypte===égypte
élise===élise
esther===esther
euphrate===euphrate
hellespont===hellespont
hydaspe===hydaspe
inde===inde
israël===israël
israélite===israélite
israélites===israélites
jacob===jacob
jérusalem===jérusalem
jourdain===jourdain
mardochée===mardochée
perse===perse
rhin===rhin
scythe===scythe
sion===sion
thamar===thamar
tharès===tharès
thrace===thrace
vasthi===vasthi
zarès===zarès
gardes du roi assuérus===gardes du roi assuérus
choeur de jeunes filles israélites===choeur de jeunes filles israélites
la piété===la piété
