encore===encore
mais===mais
tout===tout
ainsi===ainsi
toujours===toujours
là===là
alors===alors
si===si
seulement===seulement
déjà===déjà
souvent===souvent
ailleurs===ailleurs
surtout===surtout
ici===ici
près===près
également===également
ensemble===ensemble
cependant===cependant
fort===fort
enfin===enfin
depuis===depuis
loin===loin
mal===mal
ensuite===ensuite
plutôt===plutôt
notamment===notamment
tard===tard
longtemps===longtemps
parfois===parfois
maintenant===maintenant
fin===fin
selon===selon
particulièrement===particulièrement
pourtant===pourtant
bas===bas
environ===environ
delà===delà
devant===devant
bientôt===bientôt
généralement===généralement
parmi===parmi
guère===guère
partout===partout
directement===directement
simplement===simplement
juste===juste
entièrement===entièrement
quelquefois===quelquefois
immédiatement===immédiatement
parfaitement===parfaitement
rapidement===rapidement
actuellement===actuellement
relativement===relativement
absolument===absolument
vraiment===vraiment
complètement===complètement
désormais===désormais
précisément===précisément
facilement===facilement
évidemment===évidemment
vite===vite
aussitôt===aussitôt
dessus===dessus
essentiellement===essentiellement
tantôt===tantôt
autrement===autrement
exactement===exactement
nécessairement===nécessairement
haut===haut
certainement===certainement
probablement===probablement
néanmoins===néanmoins
naturellement===naturellement
fortement===fortement
uniquement===uniquement
principalement===principalement
proprement===proprement
dehors===dehors
nettement===nettement
autrefois===autrefois
outre===outre
largement===largement
purement===purement
hors===hors
tellement===tellement
suffisamment===suffisamment
tôt===tôt
spécialement===spécialement
extrêmement===extrêmement
réellement===réellement
exclusivement===exclusivement
récemment===récemment
clairement===clairement
conformément===conformément
voire===voire
successivement===successivement
auparavant===auparavant
constamment===constamment
certes===certes
forte===forte
profondément===profondément
rarement===rarement
justement===justement
nullement===nullement
fréquemment===fréquemment
aisément===aisément
finalement===finalement
légèrement===légèrement
régulièrement===régulièrement
ordinairement===ordinairement
totalement===totalement
hier===hier
définitivement===définitivement
volontiers===volontiers
précédemment===précédemment
sensiblement===sensiblement
quasi===quasi
vivement===vivement
derrière===derrière
demain===demain
effectivement===effectivement
grave===grave
jadis===jadis
lentement===lentement
frais===frais
progressivement===progressivement
pratiquement===pratiquement
respectivement===respectivement
ibid===ibid
librement===librement
malheureusement===malheureusement
véritablement===véritablement
dessous===dessous
infiniment===infiniment
considérablement===considérablement
pleinement===pleinement
difficilement===difficilement
debout===debout
heureusement===heureusement
franco===franco
dimanche===dimanche
habituellement===habituellement
étroitement===étroitement
simultanément===simultanément
assurément===assurément
brusquement===brusquement
sérieusement===sérieusement
expressément===expressément
contrairement===contrairement
strictement===strictement
indépendamment===indépendamment
partiellement===partiellement
longuement===longuement
soigneusement===soigneusement
promptement===promptement
éventuellement===éventuellement
singulièrement===singulièrement
normalement===normalement
forcément===forcément
pareil===pareil
sûrement===sûrement
apparemment===apparemment
supra===supra
personnellement===personnellement
vraisemblablement===vraisemblablement
doux===doux
antérieurement===antérieurement
officiellement===officiellement
préalablement===préalablement
volontairement===volontairement
rigoureusement===rigoureusement
séparément===séparément
formellement===formellement
spontanément===spontanément
hautement===hautement
publiquement===publiquement
soudain===soudain
continuellement===continuellement
ouvertement===ouvertement
dedans===dedans
dur===dur
indirectement===indirectement
ultérieurement===ultérieurement
systématiquement===systématiquement
parallèlement===parallèlement
provisoirement===provisoirement
convenablement===convenablement
annuellement===annuellement
complétement===complétement
franchement===franchement
manifestement===manifestement
doucement===doucement
naguère===naguère
réciproquement===réciproquement
net===net
explicitement===explicitement
communément===communément
samedi===samedi
efficacement===efficacement
brièvement===brièvement
lundi===lundi
vainement===vainement
out===out
bis===bis
incontestablement===incontestablement
utilement===utilement
indéfiniment===indéfiniment
solidement===solidement
légalement===légalement
infra===infra
mutuellement===mutuellement
intimement===intimement
idem===idem
nouvellement===nouvellement
gravement===gravement
radicalement===radicalement
activement===activement
violemment===violemment
éminemment===éminemment
subitement===subitement
graduellement===graduellement
gratuitement===gratuitement
pareillement===pareillement
notablement===notablement
faiblement===faiblement
incessamment===incessamment
fidèlement===fidèlement
momentanément===momentanément
implicitement===implicitement
différemment===différemment
abondamment===abondamment
aucunement===aucunement
vendredi===vendredi
ter===ter
piano===piano
exceptionnellement===exceptionnellement
conjointement===conjointement
littéralement===littéralement
primitivement===primitivement
automatiquement===automatiquement
admirablement===admirablement
grandement===grandement
visiblement===visiblement
inévitablement===inévitablement
sincèrement===sincèrement
alternativement===alternativement
intégralement===intégralement
correctement===correctement
positivement===positivement
résolument===résolument
sévèrement===sévèrement
jeudi===jeudi
logiquement===logiquement
fermement===fermement
puissamment===puissamment
inutilement===inutilement
spécifiquement===spécifiquement
couramment===couramment
approximativement===approximativement
solennellement===solennellement
proportionnellement===proportionnellement
isolément===isolément
habilement===habilement
fondamentalement===fondamentalement
deçà===deçà
prochainement===prochainement
mardi===mardi
théoriquement===théoriquement
tranquillement===tranquillement
attentivement===attentivement
dûment===dûment
énergiquement===énergiquement
politiquement===politiquement
doublement===doublement
anciennement===anciennement
inversement===inversement
individuellement===individuellement
ben===ben
secrètement===secrètement
insensiblement===insensiblement
mercredi===mercredi
éternellement===éternellement
dorénavant===dorénavant
dernièrement===dernièrement
globalement===globalement
excessivement===excessivement
obligatoirement===obligatoirement
traditionnellement===traditionnellement
légitimement===légitimement
universellement===universellement
fatalement===fatalement
cruellement===cruellement
économiquement===économiquement
brutalement===brutalement
favorablement===favorablement
moralement===moralement
journellement===journellement
socialement===socialement
uniformément===uniformément
décidément===décidément
présentement===présentement
vigoureusement===vigoureusement
périodiquement===périodiquement
initialement===initialement
amplement===amplement
postérieurement===postérieurement
comparativement===comparativement
finement===finement
arbitrairement===arbitrairement
sommairement===sommairement
sagement===sagement
tardivement===tardivement
intérieurement===intérieurement
quasiment===quasiment
délibérément===délibérément
impunément===impunément
indifféremment===indifféremment
raisonnablement===raisonnablement
distinctement===distinctement
historiquement===historiquement
conséquemment===conséquemment
unanimement===unanimement
imparfaitement===imparfaitement
lourdement===lourdement
indistinctement===indistinctement
valablement===valablement
péniblement===péniblement
avantageusement===avantageusement
durement===durement
temporairement===temporairement
physiquement===physiquement
artificiellement===artificiellement
sitôt===sitôt
insuffisamment===insuffisamment
invariablement===invariablement
ores===ores
verticalement===verticalement
diversement===diversement
matériellement===matériellement
hardiment===hardiment
étrangement===étrangement
vaguement===vaguement
premièrement===premièrement
exprès===exprès
humblement===humblement
localement===localement
merveilleusement===merveilleusement
dignement===dignement
perpétuellement===perpétuellement
grossièrement===grossièrement
remarquablement===remarquablement
infailliblement===infailliblement
paradoxalement===paradoxalement
extraordinairement===extraordinairement
paisiblement===paisiblement
juridiquement===juridiquement
perpendiculairement===perpendiculairement
objectivement===objectivement
instantanément===instantanément
quotidiennement===quotidiennement
extérieurement===extérieurement
scrupuleusement===scrupuleusement
encor===encor
concrètement===concrètement
curieusement===curieusement
horizontalement===horizontalement
ardemment===ardemment
souverainement===souverainement
minutieusement===minutieusement
énormément===énormément
injustement===injustement
richement===richement
généreusement===généreusement
discrètement===discrètement
çà===çà
obliquement===obliquement
comptant===comptant
tristement===tristement
froidement===froidement
inégalement===inégalement
irrégulièrement===irrégulièrement
collectivement===collectivement
scientifiquement===scientifiquement
textuellement===textuellement
expérimentalement===expérimentalement
agréablement===agréablement
accidentellement===accidentellement
primo===primo
patiemment===patiemment
judicieusement===judicieusement
originairement===originairement
passablement===passablement
médiocrement===médiocrement
faussement===faussement
passim===passim
prudemment===prudemment
latéralement===latéralement
méthodiquement===méthodiquement
concurremment===concurremment
modestement===modestement
obstinément===obstinément
négativement===négativement
mécaniquement===mécaniquement
involontairement===involontairement
inconsciemment===inconsciemment
tendrement===tendrement
courageusement===courageusement
terriblement===terriblement
consciemment===consciemment
ibidem===ibidem
foncièrement===foncièrement
naïvement===naïvement
précipitamment===précipitamment
loyalement===loyalement
typiquement===typiquement
impérieusement===impérieusement
soudainement===soudainement
durablement===durablement
passionnément===passionnément
off===off
sciemment===sciemment
fièrement===fièrement
diamétralement===diamétralement
rationnellement===rationnellement
amèrement===amèrement
massivement===massivement
inclusivement===inclusivement
instamment===instamment
noblement===noblement
prématurément===prématurément
majoritairement===majoritairement
aveuglément===aveuglément
confusément===confusément
magnifiquement===magnifiquement
virtuellement===virtuellement
techniquement===techniquement
savamment===savamment
potentiellement===potentiellement
militairement===militairement
victorieusement===victorieusement
irrévocablement===irrévocablement
dangereusement===dangereusement
solidairement===solidairement
nommément===nommément
adroitement===adroitement
fraîchement===fraîchement
brillamment===brillamment
douloureusement===douloureusement
religieusement===religieusement
vulgairement===vulgairement
financièrement===financièrement
transversalement===transversalement
significativement===significativement
gracieusement===gracieusement
indubitablement===indubitablement
indûment===indûment
commodément===commodément
honorablement===honorablement
tacitement===tacitement
impitoyablement===impitoyablement
symboliquement===symboliquement
timidement===timidement
incomplètement===incomplètement
imprudemment===imprudemment
honnêtement===honnêtement
carrément===carrément
inlassablement===inlassablement
prodigieusement===prodigieusement
catégoriquement===catégoriquement
irrémédiablement===irrémédiablement
verbalement===verbalement
géographiquement===géographiquement
incomparablement===incomparablement
respectueusement===respectueusement
intensément===intensément
instinctivement===instinctivement
vaillamment===vaillamment
grièvement===grièvement
bonnement===bonnement
chèrement===chèrement
incidemment===incidemment
rudement===rudement
notoirement===notoirement
authentiquement===authentiquement
consciencieusement===consciencieusement
accessoirement===accessoirement
modérément===modérément
silencieusement===silencieusement
gaiement===gaiement
mortellement===mortellement
clandestinement===clandestinement
succinctement===succinctement
numériquement===numériquement
joyeusement===joyeusement
intellectuellement===intellectuellement
désespérément===désespérément
ponctuellement===ponctuellement
hermétiquement===hermétiquement
secondairement===secondairement
ostensiblement===ostensiblement
pieusement===pieusement
mollement===mollement
glorieusement===glorieusement
symétriquement===symétriquement
quantitativement===quantitativement
équitablement===équitablement
délicatement===délicatement
civilement===civilement
spirituellement===spirituellement
sourdement===sourdement
derechef===derechef
chimiquement===chimiquement
occasionnellement===occasionnellement
démesurément===démesurément
horriblement===horriblement
chaleureusement===chaleureusement
intentionnellement===intentionnellement
litt===litt
identiquement===identiquement
superficiellement===superficiellement
statistiquement===statistiquement
contradictoirement===contradictoirement
étonnamment===étonnamment
aimablement===aimablement
hâtivement===hâtivement
bruyamment===bruyamment
empiriquement===empiriquement
miraculeusement===miraculeusement
bravement===bravement
affirmativement===affirmativement
familièrement===familièrement
abusivement===abusivement
moyennement===moyennement
inopinément===inopinément
passivement===passivement
harmonieusement===harmonieusement
follement===follement
improprement===improprement
humainement===humainement
misérablement===misérablement
impatiemment===impatiemment
irrésistiblement===irrésistiblement
qualitativement===qualitativement
maladroitement===maladroitement
avidement===avidement
mentalement===mentalement
illégalement===illégalement
indiscutablement===indiscutablement
intrinsèquement===intrinsèquement
assidûment===assidûment
gentiment===gentiment
immanquablement===immanquablement
cordialement===cordialement
invinciblement===invinciblement
ironiquement===ironiquement
prou===prou
alias===alias
culturellement===culturellement
mûrement===mûrement
obscurément===obscurément
psychologiquement===psychologiquement
lâchement===lâchement
laborieusement===laborieusement
impérativement===impérativement
anormalement===anormalement
mystérieusement===mystérieusement
semblablement===semblablement
joliment===joliment
machinalement===machinalement
indissolublement===indissolublement
supérieurement===supérieurement
mathématiquement===mathématiquement
sainement===sainement
schématiquement===schématiquement
jalousement===jalousement
poliment===poliment
chaudement===chaudement
substantiellement===substantiellement
éloquemment===éloquemment
unilatéralement===unilatéralement
précocement===précocement
allègrement===allègrement
pacifiquement===pacifiquement
item===item
libéralement===libéralement
env===env
précieusement===précieusement
philosophiquement===philosophiquement
inéluctablement===inéluctablement
élégamment===élégamment
excellemment===excellemment
ingénieusement===ingénieusement
amicalement===amicalement
furtivement===furtivement
originellement===originellement
complaisamment===complaisamment
alentour===alentour
honteusement===honteusement
chronologiquement===chronologiquement
surabondamment===surabondamment
classiquement===classiquement
idéalement===idéalement
affectueusement===affectueusement
cliniquement===cliniquement
corrélativement===corrélativement
oralement===oralement
sèchement===sèchement
prétendument===prétendument
subsidiairement===subsidiairement
opportunément===opportunément
administrativement===administrativement
fixement===fixement
prioritairement===prioritairement
consécutivement===consécutivement
inexorablement===inexorablement
quarto===quarto
rétrospectivement===rétrospectivement
furieusement===furieusement
graphiquement===graphiquement
magistralement===magistralement
farouchement===farouchement
subtilement===subtilement
pertinemment===pertinemment
deuxièmement===deuxièmement
délicieusement===délicieusement
mensuellement===mensuellement
indignement===indignement
intelligemment===intelligemment
longitudinalement===longitudinalement
triomphalement===triomphalement
plaisamment===plaisamment
docilement===docilement
exagérément===exagérément
industriellement===industriellement
indéniablement===indéniablement
bizarrement===bizarrement
frauduleusement===frauduleusement
superbement===superbement
négligemment===négligemment
servilement===servilement
génétiquement===génétiquement
âprement===âprement
confortablement===confortablement
judiciairement===judiciairement
décemment===décemment
dédaigneusement===dédaigneusement
électriquement===électriquement
péremptoirement===péremptoirement
audacieusement===audacieusement
démocratiquement===démocratiquement
tragiquement===tragiquement
adéquatement===adéquatement
calmement===calmement
subjectivement===subjectivement
subrepticement===subrepticement
idéologiquement===idéologiquement
obligeamment===obligeamment
inconsidérément===inconsidérément
intuitivement===intuitivement
géométriquement===géométriquement
gratis===gratis
ridiculement===ridiculement
héroïquement===héroïquement
fraternellement===fraternellement
affreusement===affreusement
physiologiquement===physiologiquement
secundo===secundo
constitutionnellement===constitutionnellement
copieusement===copieusement
secondement===secondement
commercialement===commercialement
cash===cash
officieusement===officieusement
fortuitement===fortuitement
céans===céans
éperdument===éperdument
organiquement===organiquement
internationalement===internationalement
sobrement===sobrement
sexuellement===sexuellement
nominativement===nominativement
nominalement===nominalement
circulairement===circulairement
malicieusement===malicieusement
confidentiellement===confidentiellement
innocemment===innocemment
majestueusement===majestueusement
artistement===artistement
divinement===divinement
vertement===vertement
pompeusement===pompeusement
structurellement===structurellement
bêtement===bêtement
immensément===immensément
professionnellement===professionnellement
lestement===lestement
sournoisement===sournoisement
continûment===continûment
méchamment===méchamment
malaisément===malaisément
morphologiquement===morphologiquement
passagèrement===passagèrement
crûment===crûment
abstraitement===abstraitement
témérairement===témérairement
fâcheusement===fâcheusement
bénévolement===bénévolement
ingénument===ingénument
inférieurement===inférieurement
hiérarchiquement===hiérarchiquement
inviolablement===inviolablement
saintement===saintement
insolemment===insolemment
diligemment===diligemment
manuellement===manuellement
imperceptiblement===imperceptiblement
rétroactivement===rétroactivement
amoureusement===amoureusement
octavo===octavo
pauvrement===pauvrement
héréditairement===héréditairement
linéairement===linéairement
sémantiquement===sémantiquement
poétiquement===poétiquement
préférablement===préférablement
analytiquement===analytiquement
insidieusement===insidieusement
défavorablement===défavorablement
visuellement===visuellement
conventionnellement===conventionnellement
lamentablement===lamentablement
incroyablement===incroyablement
sottement===sottement
impartialement===impartialement
ultimo===ultimo
biologiquement===biologiquement
dito===dito
prestement===prestement
inséparablement===inséparablement
fonctionnellement===fonctionnellement
effrontément===effrontément
marre===marre
troisièmement===troisièmement
anatomiquement===anatomiquement
bassement===bassement
médicalement===médicalement
dramatiquement===dramatiquement
médiatement===médiatement
dévotement===dévotement
subito===subito
inexactement===inexactement
malencontreusement===malencontreusement
désagréablement===désagréablement
fictivement===fictivement
métaphoriquement===métaphoriquement
sporadiquement===sporadiquement
sociologiquement===sociologiquement
préférentiellement===préférentiellement
nonchalamment===nonchalamment
sauvagement===sauvagement
opiniâtrement===opiniâtrement
outrageusement===outrageusement
limitativement===limitativement
courtoisement===courtoisement
pénalement===pénalement
cyniquement===cyniquement
préventivement===préventivement
nerveusement===nerveusement
tertio===tertio
chrétiennement===chrétiennement
distraitement===distraitement
uniment===uniment
densément===densément
posément===posément
ci-dessous===ci-dessous
pesamment===pesamment
indispensablement===indispensablement
sereinement===sereinement
rondement===rondement
stupidement===stupidement
entretemps===entretemps
mélancoliquement===mélancoliquement
oncques===oncques
pudiquement===pudiquement
imperturbablement===imperturbablement
somptueusement===somptueusement
orgueilleusement===orgueilleusement
épisodiquement===épisodiquement
anxieusement===anxieusement
spatialement===spatialement
dialectiquement===dialectiquement
ontologiquement===ontologiquement
fiévreusement===fiévreusement
inextricablement===inextricablement
gaîment===gaîment
esthétiquement===esthétiquement
traîtreusement===traîtreusement
linguistiquement===linguistiquement
atrocement===atrocement
scandaleusement===scandaleusement
férocement===férocement
triplement===triplement
lucidement===lucidement
littérairement===littérairement
étymologiquement===étymologiquement
rituellement===rituellement
gauchement===gauchement
recta===recta
hypocritement===hypocritement
piteusement===piteusement
presto===presto
charitablement===charitablement
irréductiblement===irréductiblement
processionnellement===processionnellement
galamment===galamment
fructueusement===fructueusement
conditionnellement===conditionnellement
parcimonieusement===parcimonieusement
inconditionnellement===inconditionnellement
drôlement===drôlement
quater===quater
musicalement===musicalement
perfidement===perfidement
grammaticalement===grammaticalement
diplomatiquement===diplomatiquement
impudemment===impudemment
cumulativement===cumulativement
prosaïquement===prosaïquement
stratégiquement===stratégiquement
splendidement===splendidement
méticuleusement===méticuleusement
territorialement===territorialement
vulgo===vulgo
temporellement===temporellement
odieusement===odieusement
métaphysiquement===métaphysiquement
mondialement===mondialement
conceptuellement===conceptuellement
canoniquement===canoniquement
optiquement===optiquement
ci-dessus===ci-dessus
implacablement===implacablement
corporellement===corporellement
grassement===grassement
fébrilement===fébrilement
immuablement===immuablement
psychiquement===psychiquement
lisiblement===lisiblement
dogmatiquement===dogmatiquement
trimestriellement===trimestriellement
frénétiquement===frénétiquement
interminablement===interminablement
effroyablement===effroyablement
criminellement===criminellement
paresseusement===paresseusement
quinto===quinto
ignominieusement===ignominieusement
royalement===royalement
convulsivement===convulsivement
chichement===chichement
impétueusement===impétueusement
institutionnellement===institutionnellement
affectivement===affectivement
pécuniairement===pécuniairement
statutairement===statutairement
nationalement===nationalement
platement===platement
tangentiellement===tangentiellement
nuitamment===nuitamment
étourdiment===étourdiment
phonétiquement===phonétiquement
synthétiquement===synthétiquement
intensivement===intensivement
indissociablement===indissociablement
despotiquement===despotiquement
usuellement===usuellement
magiquement===magiquement
possiblement===possiblement
contractuellement===contractuellement
crescendo===crescendo
rageusement===rageusement
marginalement===marginalement
tumultueusement===tumultueusement
indiscrètement===indiscrètement
ultimement===ultimement
dynamiquement===dynamiquement
largo===largo
capricieusement===capricieusement
artistiquement===artistiquement
texto===texto
ethniquement===ethniquement
sympathiquement===sympathiquement
exemplairement===exemplairement
hypothétiquement===hypothétiquement
législativement===législativement
paternellement===paternellement
intrépidement===intrépidement
licitement===licitement
sélectivement===sélectivement
histologiquement===histologiquement
rigidement===rigidement
souterrainement===souterrainement
déplorablement===déplorablement
réglementairement===réglementairement
dolce===dolce
théologiquement===théologiquement
voluptueusement===voluptueusement
forfaitairement===forfaitairement
électivement===électivement
subséquemment===subséquemment
syntaxiquement===syntaxiquement
aigrement===aigrement
anonymement===anonymement
spectaculairement===spectaculairement
dru===dru
amiablement===amiablement
formidablement===formidablement
providentiellement===providentiellement
laconiquement===laconiquement
pedibus===pedibus
restrictivement===restrictivement
banalement===banalement
suprêmement===suprêmement
pittoresquement===pittoresquement
transitoirement===transitoirement
lumineusement===lumineusement
analogiquement===analogiquement
écologiquement===écologiquement
luxueusement===luxueusement
algébriquement===algébriquement
illico===illico
cavalièrement===cavalièrement
sexto===sexto
doctement===doctement
infatigablement===infatigablement
decimo===decimo
malignement===malignement
coquettement===coquettement
onques===onques
technologiquement===technologiquement
abruptement===abruptement
dorsalement===dorsalement
surement===surement
monstrueusement===monstrueusement
gaillardement===gaillardement
astucieusement===astucieusement
pêlemêle===pêlemêle
infructueusement===infructueusement
chirurgicalement===chirurgicalement
solitairement===solitairement
macroscopiquement===macroscopiquement
méthodologiquement===méthodologiquement
concentriquement===concentriquement
impeccablement===impeccablement
inébranlablement===inébranlablement
facultativement===facultativement
autoritairement===autoritairement
ventralement===ventralement
fugitivement===fugitivement
irréversiblement===irréversiblement
stoïquement===stoïquement
harmoniquement===harmoniquement
véhémentement===véhémentement
tendanciellement===tendanciellement
nono===nono
géologiquement===géologiquement
révolutionnairement===révolutionnairement
inhumainement===inhumainement
exhaustivement===exhaustivement
andante===andante
privativement===privativement
diagonalement===diagonalement
petitement===petitement
fiscalement===fiscalement
virilement===virilement
censément===censément
adonc===adonc
régionalement===régionalement
crânement===crânement
itérativement===itérativement
illicitement===illicitement
thermiquement===thermiquement
vertueusement===vertueusement
invisiblement===invisiblement
aseptiquement===aseptiquement
erronément===erronément
aléatoirement===aléatoirement
frontalement===frontalement
primordialement===primordialement
génériquement===génériquement
septimo===septimo
validement===validement
diablement===diablement
bourgeoisement===bourgeoisement
là-bas===là-bas
absurdement===absurdement
égoïstement===égoïstement
incorrectement===incorrectement
démographiquement===démographiquement
émotionnellement===émotionnellement
télégraphiquement===télégraphiquement
décisivement===décisivement
radialement===radialement
chroniquement===chroniquement
sentimentalement===sentimentalement
centralement===centralement
tenuto===tenuto
asymptotiquement===asymptotiquement
imaginairement===imaginairement
cérémonieusement===cérémonieusement
plastiquement===plastiquement
indivisiblement===indivisiblement
topographiquement===topographiquement
stérilement===stérilement
goulûment===goulûment
abominablement===abominablement
fastueusement===fastueusement
pragmatiquement===pragmatiquement
inexplicablement===inexplicablement
synchroniquement===synchroniquement
rythmiquement===rythmiquement
éthiquement===éthiquement
vitalement===vitalement
hebdomadairement===hebdomadairement
scherzo===scherzo
agressivement===agressivement
bellement===bellement
candidement===candidement
précautionneusement===précautionneusement
viscéralement===viscéralement
correctionnellement===correctionnellement
chastement===chastement
hypothécairement===hypothécairement
niaisement===niaisement
spéculativement===spéculativement
pédagogiquement===pédagogiquement
charnellement===charnellement
électoralement===électoralement
sensément===sensément
tyranniquement===tyranniquement
mêmement===mêmement
mystiquement===mystiquement
béatement===béatement
structuralement===structuralement
vertigineusement===vertigineusement
allegro===allegro
puérilement===puérilement
offensivement===offensivement
comiquement===comiquement
dérisoirement===dérisoirement
alphabétiquement===alphabétiquement
thématiquement===thématiquement
sinistrement===sinistrement
discrétionnairement===discrétionnairement
pitoyablement===pitoyablement
surnaturellement===surnaturellement
illusoirement===illusoirement
lugubrement===lugubrement
concomitamment===concomitamment
statiquement===statiquement
intelligiblement===intelligiblement
pathétiquement===pathétiquement
allégoriquement===allégoriquement
inflexiblement===inflexiblement
indivisément===indivisément
pianissimo===pianissimo
artificieusement===artificieusement
existentiellement===existentiellement
indéfectiblement===indéfectiblement
radiologiquement===radiologiquement
frileusement===frileusement
illégitimement===illégitimement
ci-après===ci-après
placidement===placidement
maritalement===maritalement
évasivement===évasivement
épistémologiquement===épistémologiquement
emphatiquement===emphatiquement
pensivement===pensivement
moindrement===moindrement
languissamment===languissamment
patriotiquement===patriotiquement
souplement===souplement
hostilement===hostilement
électroniquement===électroniquement
maigrement===maigrement
intempestivement===intempestivement
causalement===causalement
disciplinairement===disciplinairement
doctrinalement===doctrinalement
quatrièmement===quatrièmement
épidémiquement===épidémiquement
pathologiquement===pathologiquement
arithmétiquement===arithmétiquement
prophétiquement===prophétiquement
dextrement===dextrement
bilatéralement===bilatéralement
corollairement===corollairement
lointainement===lointainement
pontificalement===pontificalement
photographiquement===photographiquement
originalement===originalement
préliminairement===préliminairement
phénoménologiquement===phénoménologiquement
là-dessus===là-dessus
sentencieusement===sentencieusement
stylistiquement===stylistiquement
vachement===vachement
irréfutablement===irréfutablement
péjorativement===péjorativement
figurément===figurément
irrévérencieusement===irrévérencieusement
univoquement===univoquement
mensongèrement===mensongèrement
vilainement===vilainement
tactiquement===tactiquement
semestriellement===semestriellement
drastiquement===drastiquement
grotesquement===grotesquement
complémentairement===complémentairement
allusivement===allusivement
droitement===droitement
constitutivement===constitutivement
courtement===courtement
vicieusement===vicieusement
legato===legato
exponentiellement===exponentiellement
démonstrativement===démonstrativement
adagio===adagio
congénitalement===congénitalement
excentriquement===excentriquement
salement===salement
stratigraphiquement===stratigraphiquement
irréparablement===irréparablement
critiquement===critiquement
reconventionnellement===reconventionnellement
indécemment===indécemment
théâtralement===théâtralement
mesquinement===mesquinement
suavement===suavement
substantivement===substantivement
trivialement===trivialement
magnétiquement===magnétiquement
fabuleusement===fabuleusement
défensivement===défensivement
iniquement===iniquement
proverbialement===proverbialement
mordicus===mordicus
paritairement===paritairement
microscopiquement===microscopiquement
sombrement===sombrement
réflexivement===réflexivement
lexicalement===lexicalement
fantastiquement===fantastiquement
fragmentairement===fragmentairement
typographiquement===typographiquement
génialement===génialement
scolairement===scolairement
redoutablement===redoutablement
épouvantablement===épouvantablement
séculairement===séculairement
confidemment===confidemment
extemporanément===extemporanément
rêveusement===rêveusement
benoîtement===benoîtement
craintivement===craintivement
immodérément===immodérément
équivalemment===équivalemment
incurablement===incurablement
déterminément===déterminément
tenacement===tenacement
hideusement===hideusement
fanatiquement===fanatiquement
maternellement===maternellement
populairement===populairement
anticipativement===anticipativement
extensivement===extensivement
persévéramment===persévéramment
diaboliquement===diaboliquement
astronomiquement===astronomiquement
compétemment===compétemment
prétendûment===prétendûment
furioso===furioso
irrémissiblement===irrémissiblement
précairement===précairement
injurieusement===injurieusement
adorablement===adorablement
déductivement===déductivement
bactériologiquement===bactériologiquement
collégialement===collégialement
rectilignement===rectilignement
gaiment===gaiment
ambitieusement===ambitieusement
bénignement===bénignement
anthropologiquement===anthropologiquement
dépendamment===dépendamment
inopportunément===inopportunément
discursivement===discursivement
fougueusement===fougueusement
fantasmatiquement===fantasmatiquement
orthogonalement===orthogonalement
gloutonnement===gloutonnement
proportionnément===proportionnément
téléphoniquement===téléphoniquement
inépuisablement===inépuisablement
prétentieusement===prétentieusement
calomnieusement===calomnieusement
cognitivement===cognitivement
fallacieusement===fallacieusement
séquentiellement===séquentiellement
racialement===racialement
phonologiquement===phonologiquement
archéologiquement===archéologiquement
narcissiquement===narcissiquement
coutumièrement===coutumièrement
hydrauliquement===hydrauliquement
ignoblement===ignoblement
malhonnêtement===malhonnêtement
indiciblement===indiciblement
bougrement===bougrement
élastiquement===élastiquement
barbarement===barbarement
figurativement===figurativement
itou===itou
désavantageusement===désavantageusement
inhabituellement===inhabituellement
supposément===supposément
typologiquement===typologiquement
amoroso===amoroso
lyriquement===lyriquement
anarchiquement===anarchiquement
invraisemblablement===invraisemblablement
outre-mer===outre-mer
impersonnellement===impersonnellement
ci-avant===ci-avant
fissa===fissa
douillettement===douillettement
nativement===nativement
valeureusement===valeureusement
maladivement===maladivement
peureusement===peureusement
elliptiquement===elliptiquement
mélodieusement===mélodieusement
saisonnièrement===saisonnièrement
spasmodiquement===spasmodiquement
différentiellement===différentiellement
symptomatiquement===symptomatiquement
axialement===axialement
fautivement===fautivement
salutairement===salutairement
lento===lento
productivement===productivement
irréprochablement===irréprochablement
sensuellement===sensuellement
exquisement===exquisement
inductivement===inductivement
véridiquement===véridiquement
ici-bas===ici-bas
diachroniquement===diachroniquement
provisionnellement===provisionnellement
médiatiquement===médiatiquement
platoniquement===platoniquement
énergétiquement===énergétiquement
miséricordieusement===miséricordieusement
rubato===rubato
allégrement===allégrement
énigmatiquement===énigmatiquement
insupportablement===insupportablement
sostenuto===sostenuto
conjoncturellement===conjoncturellement
phylogénétiquement===phylogénétiquement
catholiquement===catholiquement
gracioso===gracioso
transcendantalement===transcendantalement
frugalement===frugalement
féodalement===féodalement
angulairement===angulairement
métonymiquement===métonymiquement
normativement===normativement
profitablement===profitablement
fortissimo===fortissimo
déraisonnablement===déraisonnablement
syndicalement===syndicalement
arrogamment===arrogamment
métalliquement===métalliquement
minimalement===minimalement
incommensurablement===incommensurablement
cycliquement===cycliquement
industrieusement===industrieusement
superstitieusement===superstitieusement
vitement===vitement
opérationnellement===opérationnellement
déloyalement===déloyalement
contextuellement===contextuellement
indolemment===indolemment
élogieusement===élogieusement
vocalement===vocalement
tectoniquement===tectoniquement
didactiquement===didactiquement
crucialement===crucialement
récursivement===récursivement
primairement===primairement
académiquement===académiquement
assidument===assidument
rhétoriquement===rhétoriquement
là-haut===là-haut
unitairement===unitairement
principiellement===principiellement
minéralogiquement===minéralogiquement
référentiellement===référentiellement
langoureusement===langoureusement
sempiternellement===sempiternellement
narrativement===narrativement
désastreusement===désastreusement
acoustiquement===acoustiquement
infidèlement===infidèlement
irrécusablement===irrécusablement
axiologiquement===axiologiquement
expressivement===expressivement
outrancièrement===outrancièrement
opératoirement===opératoirement
topologiquement===topologiquement
perspectivement===perspectivement
impassiblement===impassiblement
haineusement===haineusement
architecturalement===architecturalement
généalogiquement===généalogiquement
ineffablement===ineffablement
staccato===staccato
répétitivement===répétitivement
aristocratiquement===aristocratiquement
moderato===moderato
doctoralement===doctoralement
sarcastiquement===sarcastiquement
hautainement===hautainement
nostalgiquement===nostalgiquement
variablement===variablement
congrûment===congrûment
plaintivement===plaintivement
pédestrement===pédestrement
hygiéniquement===hygiéniquement
savoureusement===savoureusement
obsessionnellement===obsessionnellement
téléologiquement===téléologiquement
budgétairement===budgétairement
ci-devant===ci-devant
mélodiquement===mélodiquement
decrescendo===decrescendo
phénoménalement===phénoménalement
artisanalement===artisanalement
sacramentellement===sacramentellement
sportivement===sportivement
consubstantiellement===consubstantiellement
romantiquement===romantiquement
extrinsèquement===extrinsèquement
élémentairement===élémentairement
picturalement===picturalement
tendancieusement===tendancieusement
sérologiquement===sérologiquement
flegmatiquement===flegmatiquement
studieusement===studieusement
adjectivement===adjectivement
caricaturalement===caricaturalement
appréciablement===appréciablement
monétairement===monétairement
sacrément===sacrément
regrettablement===regrettablement
cantabile===cantabile
informellement===informellement
vilement===vilement
thermodynamiquement===thermodynamiquement
irrationnellement===irrationnellement
cérébralement===cérébralement
réversiblement===réversiblement
diatoniquement===diatoniquement
scéniquement===scéniquement
princièrement===princièrement
cinquièmement===cinquièmement
familialement===familialement
philologiquement===philologiquement
irrespectueusement===irrespectueusement
impertinemment===impertinemment
climatiquement===climatiquement
impulsivement===impulsivement
auditivement===auditivement
alertement===alertement
sectoriellement===sectoriellement
projectivement===projectivement
fraichement===fraichement
cinématographiquement===cinématographiquement
multiplement===multiplement
coûteusement===coûteusement
intarissablement===intarissablement
nument===nument
apodictiquement===apodictiquement
distributivement===distributivement
sordidement===sordidement
caractéristiquement===caractéristiquement
plausiblement===plausiblement
présomptueusement===présomptueusement
pervertissement===pervertissement
dubitativement===dubitativement
similairement===similairement
irréfragablement===irréfragablement
capitulairement===capitulairement
botaniquement===botaniquement
démagogiquement===démagogiquement
intolérablement===intolérablement
périlleusement===périlleusement
anachroniquement===anachroniquement
disertement===disertement
partialement===partialement
moléculairement===moléculairement
emblématiquement===emblématiquement
régressivement===régressivement
bigrement===bigrement
factuellement===factuellement
compulsivement===compulsivement
allégro===allégro
thérapeutiquement===thérapeutiquement
endémiquement===endémiquement
immunologiquement===immunologiquement
mollo===mollo
colossalement===colossalement
sémiotiquement===sémiotiquement
inaltérablement===inaltérablement
instrumentalement===instrumentalement
chromatiquement===chromatiquement
psychanalytiquement===psychanalytiquement
incompréhensiblement===incompréhensiblement
sublimement===sublimement
illogiquement===illogiquement
bureaucratiquement===bureaucratiquement
trompeusement===trompeusement
agilement===agilement
superlativement===superlativement
synergiquement===synergiquement
burlesquement===burlesquement
vaniteusement===vaniteusement
trigonométriquement===trigonométriquement
fugacement===fugacement
supplémentairement===supplémentairement
hyperboliquement===hyperboliquement
nûment===nûment
émotivement===émotivement
diffusément===diffusément
axiomatiquement===axiomatiquement
multilatéralement===multilatéralement
parlementairement===parlementairement
perversement===perversement
civiquement===civiquement
inexprimablement===inexprimablement
humoristiquement===humoristiquement
égalitairement===égalitairement
doucereusement===doucereusement
adiabatiquement===adiabatiquement
immortellement===immortellement
zoologiquement===zoologiquement
voracement===voracement
narquoisement===narquoisement
phoniquement===phoniquement
inconstitutionnellement===inconstitutionnellement
comptablement===comptablement
hargneusement===hargneusement
facticement===facticement
périphériquement===périphériquement
corporativement===corporativement
transitivement===transitivement
problématiquement===problématiquement
grandiosement===grandiosement
subconsciemment===subconsciemment
érotiquement===érotiquement
inadéquatement===inadéquatement
lapidairement===lapidairement
inconstamment===inconstamment
dument===dument
imaginativement===imaginativement
impudiquement===impudiquement
pédantesquement===pédantesquement
laidement===laidement
bestialement===bestialement
polémiquement===polémiquement
profusément===profusément
adverbialement===adverbialement
ci-contre===ci-contre
spécieusement===spécieusement
cytologiquement===cytologiquement
asymétriquement===asymétriquement
moelleusement===moelleusement
agitato===agitato
pernicieusement===pernicieusement
bienveillamment===bienveillamment
magnanimement===magnanimement
topiquement===topiquement
additionnellement===additionnellement
contemporainement===contemporainement
forté===forté
austèrement===austèrement
roidement===roidement
défectueusement===défectueusement
compendieusement===compendieusement
animato===animato
extrajudiciairement===extrajudiciairement
inconfortablement===inconfortablement
occultement===occultement
ennuyeusement===ennuyeusement
chétivement===chétivement
impoliment===impoliment
espressivo===espressivo
doucettement===doucettement
liturgiquement===liturgiquement
bibliquement===bibliquement
chevaleresquement===chevaleresquement
filialement===filialement
malproprement===malproprement
là-dedans===là-dedans
fastidieusement===fastidieusement
fameusement===fameusement
phénotypiquement===phénotypiquement
maussadement===maussadement
conjugalement===conjugalement
aventureusement===aventureusement
sadiquement===sadiquement
radieusement===radieusement
vx===souventefois
orthographiquement===orthographiquement
dictatorialement===dictatorialement
amabile===amabile
minoritairement===minoritairement
ineffaçablement===ineffaçablement
muettement===muettement
rudimentairement===rudimentairement
jovialement===jovialement
monarchiquement===monarchiquement
dévotieusement===dévotieusement
communautairement===communautairement
informatiquement===informatiquement
mythologiquement===mythologiquement
appassionato===appassionato
insatiablement===insatiablement
machiavéliquement===machiavéliquement
méritoirement===méritoirement
conjecturalement===conjecturalement
pneumatiquement===pneumatiquement
maximalement===maximalement
douteusement===douteusement
maestoso===maestoso
végétativement===végétativement
fragilement===fragilement
louablement===louablement
mimétiquement===mimétiquement
triangulairement===triangulairement
cinématiquement===cinématiquement
sémiologiquement===sémiologiquement
railleusement===railleusement
diminuendo===diminuendo
malhabilement===malhabilement
jusque-là===jusque-là
immémorialement===immémorialement
mauvaisement===mauvaisement
cauteleusement===cauteleusement
fervemment===fervemment
urgemment===urgemment
capitalement===capitalement
tapageusement===tapageusement
protocolairement===protocolairement
sur-le-champ===sur-le-champ
consensuellement===consensuellement
confessionnellement===confessionnellement
suggestivement===suggestivement
hystériquement===hystériquement
ténébreusement===ténébreusement
obséquieusement===obséquieusement
impérialement===impérialement
lucrativement===lucrativement
révérencieusement===révérencieusement
débonnairement===débonnairement
ostentatoirement===ostentatoirement
tolérablement===tolérablement
immatériellement===immatériellement
ethnologiquement===ethnologiquement
soi-disant===soi-disant
robustement===robustement
indélébilement===indélébilement
heuristiquement===heuristiquement
dextrorsum===dextrorsum
avarement===avarement
allegretto===allegretto
dispendieusement===dispendieusement
inefficacement===inefficacement
piètrement===piètrement
hospitalièrement===hospitalièrement
cursivement===cursivement
morbidement===morbidement
romanesquement===romanesquement
lascivement===lascivement
adoncques===adoncques
biochimiquement===biochimiquement
additivement===additivement
facétieusement===facétieusement
parodiquement===parodiquement
coupablement===coupablement
tautologiquement===tautologiquement
oisivement===oisivement
insoucieusement===insoucieusement
imprévisiblement===imprévisiblement
ancestralement===ancestralement
tortueusement===tortueusement
funestement===funestement
musculairement===musculairement
flatteusement===flatteusement
géopolitiquement===géopolitiquement
tactilement===tactilement
détestablement===détestablement
consulairement===consulairement
inconcevablement===inconcevablement
optimalement===optimalement
isotopiquement===isotopiquement
disgracieusement===disgracieusement
avant-hier===avant-hier
collatéralement===collatéralement
pêle-mêle===pêle-mêle
rustiquement===rustiquement
passionnellement===passionnellement
tièdement===tièdement
anecdotiquement===anecdotiquement
indument===indument
séditieusement===séditieusement
mondainement===mondainement
larghetto===larghetto
somatiquement===somatiquement
interactivement===interactivement
enfantinement===enfantinement
réalistement===réalistement
monotonement===monotonement
perceptiblement===perceptiblement
extatiquement===extatiquement
animalement===animalement
jointivement===jointivement
incorrigiblement===incorrigiblement
licencieusement===licencieusement
expéditivement===expéditivement
insciemment===insciemment
bienheureusement===bienheureusement
anaphoriquement===anaphoriquement
frivolement===frivolement
interrogativement===interrogativement
incommodément===incommodément
circonstanciellement===circonstanciellement
intramuros===intramuros
murement===murement
déontologiquement===déontologiquement
orthopédiquement===orthopédiquement
plantureusement===plantureusement
atomiquement===atomiquement
ludiquement===ludiquement
biographiquement===biographiquement
catastrophiquement===catastrophiquement
morganatiquement===morganatiquement
congrument===congrument
intemporellement===intemporellement
futilement===futilement
sixièmement===sixièmement
onéreusement===onéreusement
prolixement===prolixement
relationnellement===relationnellement
intransitivement===intransitivement
casuellement===casuellement
patriarcalement===patriarcalement
éphémèrement===éphémèrement
cocassement===cocassement
évangéliquement===évangéliquement
ataviquement===ataviquement
tangiblement===tangiblement
programmatiquement===programmatiquement
incongrûment===incongrûment
hasardeusement===hasardeusement
coniquement===coniquement
admirativement===admirativement
scherzando===scherzando
vastement===vastement
cinétiquement===cinétiquement
galvaniquement===galvaniquement
angéliquement===angéliquement
diantrement===diantrement
sinusoïdalement===sinusoïdalement
chaotiquement===chaotiquement
gratos===gratos
chimériquement===chimériquement
décorativement===décorativement
mignonnement===mignonnement
organisationnellement===organisationnellement
spectralement===spectralement
géométralement===géométralement
géodésiquement===géodésiquement
pairement===pairement
importunément===importunément
ecclésiastiquement===ecclésiastiquement
andantino===andantino
inoubliablement===inoubliablement
pastoralement===pastoralement
innombrablement===innombrablement
agronomiquement===agronomiquement
sinueusement===sinueusement
entre-temps===entre-temps
indestructiblement===indestructiblement
abréviativement===abréviativement
risiblement===risiblement
après-demain===après-demain
prodigalement===prodigalement
cosmiquement===cosmiquement
indulgemment===indulgemment
fichtrement===fichtrement
moqueusement===moqueusement
désordonnément===désordonnément
disproportionnellement===disproportionnellement
stablement===stablement
martialement===martialement
onctueusement===onctueusement
biunivoquement===biunivoquement
irrépressiblement===irrépressiblement
exquisément===exquisément
inespérément===inespérément
scolastiquement===scolastiquement
insouciamment===insouciamment
cérémoniellement===cérémoniellement
archaïquement===archaïquement
autocratiquement===autocratiquement
affablement===affablement
birationnellement===birationnellement
inhabilement===inhabilement
sceptiquement===sceptiquement
sforzando===sforzando
nib===nib
bénéfiquement===bénéfiquement
limpidement===limpidement
jésuitiquement===jésuitiquement
modernement===modernement
véniellement===véniellement
prestigieusement===prestigieusement
inimaginablement===inimaginablement
rinforzando===rinforzando
auxiliairement===auxiliairement
modiquement===modiquement
plénièrement===plénièrement
sardoniquement===sardoniquement
raidement===raidement
immoralement===immoralement
confraternellement===confraternellement
câlinement===câlinement
traitreusement===traitreusement
oniriquement===oniriquement
ingratement===ingratement
accelerando===accelerando
sanitairement===sanitairement
symphoniquement===symphoniquement
bimestriellement===bimestriellement
ésotériquement===ésotériquement
hiératiquement===hiératiquement
publicitairement===publicitairement
prestissimo===prestissimo
cahincaha===cahincaha
bimensuellement===bimensuellement
juvénilement===juvénilement
procéduralement===procéduralement
routinièrement===routinièrement
fadement===fadement
eschatologiquement===eschatologiquement
incivilement===incivilement
imprécisément===imprécisément
antithétiquement===antithétiquement
télépathiquement===télépathiquement
neurologiquement===neurologiquement
paraboliquement===paraboliquement
euphémiquement===euphémiquement
mielleusement===mielleusement
virginalement===virginalement
irréellement===irréellement
idiotement===idiotement
comparablement===comparablement
féeriquement===féeriquement
introspectivement===introspectivement
septièmement===septièmement
là-dessous===là-dessous
foutrement===foutrement
par-ci===par-ci
extramuros===extramuros
infernalement===infernalement
génitalement===génitalement
inintelligemment===inintelligemment
éclectiquement===éclectiquement
optionnellement===optionnellement
immodestement===immodestement
imbécilement===imbécilement
soucieusement===soucieusement
planétairement===planétairement
incestueusement===incestueusement
islamiquement===islamiquement
domestiquement===domestiquement
extravagamment===extravagamment
arbitralement===arbitralement
accortement===accortement
inaliénablement===inaliénablement
fémininement===fémininement
surhumainement===surhumainement
ascétiquement===ascétiquement
satiriquement===satiriquement
basiquement===basiquement
continument===continument
verbeusement===verbeusement
honorifiquement===honorifiquement
contagieusement===contagieusement
gigantesquement===gigantesquement
apostoliquement===apostoliquement
crapuleusement===crapuleusement
infinitésimalement===infinitésimalement
maniaquement===maniaquement
antiquement===antiquement
belliqueusement===belliqueusement
expertement===expertement
impossiblement===impossiblement
lanlaire===lanlaire
acrobatiquement===acrobatiquement
spacieusement===spacieusement
ambigument===ambigument
épidémiologiquement===épidémiologiquement
impérissablement===impérissablement
paramétriquement===paramétriquement
jeunement===jeunement
anthropomorphiquement===anthropomorphiquement
perceptuellement===perceptuellement
anguleusement===anguleusement
ombrageusement===ombrageusement
illisiblement===illisiblement
cléricalement===cléricalement
astrologiquement===astrologiquement
captieusement===captieusement
impavidement===impavidement
outre-Rhin===outre-Rhin
génotypiquement===génotypiquement
micrométriquement===micrométriquement
subversivement===subversivement
insolitement===insolitement
funèbrement===funèbrement
avaricieusement===avaricieusement
sataniquement===sataniquement
pyramidalement===pyramidalement
rasibus===rasibus
glacialement===glacialement
asexuellement===asexuellement
luxurieusement===luxurieusement
mignardement===mignardement
homologiquement===homologiquement
orageusement===orageusement
imparablement===imparablement
célestement===célestement
provincialement===provincialement
olfactivement===olfactivement
imminemment===imminemment
isothermiquement===isothermiquement
crument===crument
impénétrablement===impénétrablement
respectablement===respectablement
torrentiellement===torrentiellement
vigilamment===vigilamment
méditativement===méditativement
nutritionnellement===nutritionnellement
héraldiquement===héraldiquement
opulemment===opulemment
oiseusement===oiseusement
euphoniquement===euphoniquement
immobilement===immobilement
vaporeusement===vaporeusement
inconséquemment===inconséquemment
mesurément===mesurément
impardonnablement===impardonnablement
dolcissimo===dolcissimo
environnementalement===environnementalement
ineptement===ineptement
obsessivement===obsessivement
scalairement===scalairement
spiralement===spiralement
rogatoirement===rogatoirement
matrimonialement===matrimonialement
enharmoniquement===enharmoniquement
conciliairement===conciliairement
électromagnétiquement===électromagnétiquement
aérodynamiquement===aérodynamiquement
crédulement===crédulement
chiquement===chiquement
totalitairement===totalitairement
prévisiblement===prévisiblement
éhontément===éhontément
exécrablement===exécrablement
isomorphiquement===isomorphiquement
fielleusement===fielleusement
exégétiquement===exégétiquement
fantasquement===fantasquement
talentueusement===talentueusement
technocratiquement===technocratiquement
invalidement===invalidement
sédentairement===sédentairement
homéopathiquement===homéopathiquement
têtebêche===têtebêche
éditorialement===éditorialement
cabalistiquement===cabalistiquement
posthumément===posthumément
songeusement===songeusement
gravitationnellement===gravitationnellement
huitièmement===huitièmement
incoerciblement===incoerciblement
altièrement===altièrement
quiètement===quiètement
théocratiquement===théocratiquement
alchimiquement===alchimiquement
indomptablement===indomptablement
fatidiquement===fatidiquement
inintelligiblement===inintelligiblement
cybernétiquement===cybernétiquement
outre-Manche===outre-Manche
abjectement===abjectement
chronométriquement===chronométriquement
hypnotiquement===hypnotiquement
poussivement===poussivement
nuisiblement===nuisiblement
onduleusement===onduleusement
multiplicativement===multiplicativement
insensément===insensément
pâlement===pâlement
mornement===mornement
baroquement===baroquement
erratiquement===erratiquement
usurairement===usurairement
obscènement===obscènement
posthumement===posthumement
inimitablement===inimitablement
mutinement===mutinement
soupçonneusement===soupçonneusement
bouffonnement===bouffonnement
indéfinissablement===indéfinissablement
approbativement===approbativement
épiquement===épiquement
inexcusablement===inexcusablement
minablement===minablement
cellulairement===cellulairement
disproportionnément===disproportionnément
par-devant===par-devant
inoffensivement===inoffensivement
photosynthétiquement===photosynthétiquement
goulument===goulument
lexicographiquement===lexicographiquement
anticonstitutionnellement===anticonstitutionnellement
par-là===par-là
algorithmiquement===algorithmiquement
désobligeamment===désobligeamment
indélicatement===indélicatement
âcrement===âcrement
indécrottablement===indécrottablement
caractériellement===caractériellement
incisivement===incisivement
envieusement===envieusement
smorzando===smorzando
matinalement===matinalement
fantomatiquement===fantomatiquement
mémorablement===mémorablement
pronominalement===pronominalement
gustativement===gustativement
clopinclopant===clopinclopant
cultuellement===cultuellement
quantiquement===quantiquement
lerche===lerche
virulemment===virulemment
contentieusement===contentieusement
déplaisamment===déplaisamment
sténographiquement===sténographiquement
règlementairement===règlementairement
lubriquement===lubriquement
culinairement===culinairement
désinvoltement===désinvoltement
perspicacement===perspicacement
inintentionnellement===inintentionnellement
nébuleusement===nébuleusement
irréligieusement===irréligieusement
allégretto===allégretto
effrayamment===effrayamment
fiablement===fiablement
outre-Atlantique===outre-Atlantique
ruineusement===ruineusement
impurement===impurement
sociétalement===sociétalement
isométriquement===isométriquement
persuasivement===persuasivement
fluidement===fluidement
alcooliquement===alcooliquement
caustiquement===caustiquement
antinomiquement===antinomiquement
espièglement===espièglement
subliminalement===subliminalement
bonassement===bonassement
séculièrement===séculièrement
intra-muros===intra-muros
vestimentairement===vestimentairement
contemplativement===contemplativement
déshonnêtement===déshonnêtement
intangiblement===intangiblement
venimeusement===venimeusement
acrimonieusement===acrimonieusement
discourtoisement===discourtoisement
binairement===binairement
athlétiquement===athlétiquement
païennement===païennement
besogneusement===besogneusement
sonorement===sonorement
discontinûment===discontinûment
débilement===débilement
connement===connement
démoniaquement===démoniaquement
exotiquement===exotiquement
torrentueusement===torrentueusement
unièmement===unièmement
inélégamment===inélégamment
incorruptiblement===incorruptiblement
vénalement===vénalement
neuvièmement===neuvièmement
délectablement===délectablement
irrévéremment===irrévéremment
somnambuliquement===somnambuliquement
cupidement===cupidement
apathiquement===apathiquement
apocalyptiquement===apocalyptiquement
combinatoirement===combinatoirement
augustement===augustement
fiduciairement===fiduciairement
irraisonnablement===irraisonnablement
positionnellement===positionnellement
vénérablement===vénérablement
neutralement===neutralement
sensationnellement===sensationnellement
dilatoirement===dilatoirement
scélératement===scélératement
coléreusement===coléreusement
conventuellement===conventuellement
benoitement===benoitement
initiatiquement===initiatiquement
adent===adent
mnémoniquement===mnémoniquement
sénilement===sénilement
phonographiquement===phonographiquement
louchement===louchement
gutturalement===gutturalement
impalpablement===impalpablement
pléonastiquement===pléonastiquement
décrescendo===décrescendo
collaborativement===collaborativement
fertilement===fertilement
coquinement===coquinement
félinement===félinement
ci-haut===ci-haut
inexpiablement===inexpiablement
pâteusement===pâteusement
dégoûtamment===dégoûtamment
astralement===astralement
instructivement===instructivement
drôlatiquement===drôlatiquement
inattentivement===inattentivement
intègrement===intègrement
gauloisement===gauloisement
bucoliquement===bucoliquement
bijectivement===bijectivement
prismatiquement===prismatiquement
mercantilement===mercantilement
homériquement===homériquement
capablement===capablement
humidement===humidement
mirifiquement===mirifiquement
épatamment===épatamment
folâtrement===folâtrement
mièvrement===mièvrement
acceptablement===acceptablement
drolatiquement===drolatiquement
féériquement===féériquement
livresquement===livresquement
vélocement===vélocement
ardument===ardument
calligraphiquement===calligraphiquement
désespéramment===désespéramment
ardûment===ardûment
dixièmement===dixièmement
vindicativement===vindicativement
opaquement===opaquement
suspicieusement===suspicieusement
tête-bêche===tête-bêche
fusionnellement===fusionnellement
tridimensionnellement===tridimensionnellement
inavouablement===inavouablement
peinardement===peinardement
biquotidiennement===biquotidiennement
flasquement===flasquement
volubilement===volubilement
isentropiquement===isentropiquement
gouailleusement===gouailleusement
illustrement===illustrement
incrémentalement===incrémentalement
bézef===bézef
grivoisement===grivoisement
inconciliablement===inconciliablement
rarissimement===rarissimement
différentiablement===différentiablement
amphibologiquement===amphibologiquement
antipathiquement===antipathiquement
deuzio===deuzio
nasalement===nasalement
minimement===minimement
surprenamment===surprenamment
couardement===couardement
pondérément===pondérément
bigotement===bigotement
incongrument===incongrument
irrésolument===irrésolument
sécuritairement===sécuritairement
combativement===combativement
cahin-caha===cahin-caha
épileptiquement===épileptiquement
clopin-clopant===clopin-clopant
pusillanimement===pusillanimement
canaillement===canaillement
paillardement===paillardement
louangeusement===louangeusement
caverneusement===caverneusement
fiftyfifty===fiftyfifty
soldatesquement===soldatesquement
extra-muros===extra-muros
chouettement===chouettement
boudeusement===boudeusement
tempétueusement===tempétueusement
gourmandement===gourmandement
balourdement===balourdement
exécutoirement===exécutoirement
fourbement===fourbement
consistorialement===consistorialement
criardement===criardement
natalement===natalement
dégueulassement===dégueulassement
inactivement===inactivement
miteusement===miteusement
circonférenciellement===circonférenciellement
brumeusement===brumeusement
impensablement===impensablement
hébraïquement===hébraïquement
moitié-moitié===moitié-moitié
cuisamment===cuisamment
prolétairement===prolétairement
nigaudement===nigaudement
forte-piano===forte-piano
bésef===bésef
onzièmement===onzièmement
coucicouça===coucicouça
légato===légato
douzièmement===douzièmement
homotopiquement===homotopiquement
serviablement===serviablement
discontinument===discontinument
logiciellement===logiciellement
scénaristiquement===scénaristiquement
senestrorsum===senestrorsum
outre-Quiévrain===outre-Quiévrain
là-dehors===là-dehors
couteusement===couteusement
tranquillou===tranquillou
fifty-fifty===fifty-fifty
modérato===modérato
couci-couça===couci-couça
holomorphiquement===holomorphiquement
corolairement===corolairement
mesurablement===mesurablement
ric-rac===ric-rac
componctueusement===componctueusement
treizièmement===treizièmement
orbitalement===orbitalement
piane-piane===piane-piane
seizièmement===seizièmement
prépositivement===prépositivement
quinzièmement===quinzièmement
simplicialement===simplicialement
sororalement===sororalement
turpidement===turpidement
vingtièmement===vingtièmement
glauquement===glauquement
idolâtrement===idolâtrement
quatorzièmement===quatorzièmement
accélérando===accélérando
aujourd’hui===aujourd’hui
browniennement===browniennement
coquètement===coquètement
cotonneusement===cotonneusement
dégoutamment===dégoutamment
fuligineusement===fuligineusement
indésirablement===indésirablement
inhospitalièrement===inhospitalièrement
isenthalpiquement===isenthalpiquement
microlocalement===microlocalement
moyenâgeusement===moyenâgeusement
méromorphiquement===méromorphiquement
pénardement===pénardement
ricrac===ricrac
sosténuto===sosténuto
surjectivement===surjectivement
sénestrorsum===sénestrorsum
ténuto===ténuto
ultra-petita===ultra-petita
ultrapétita===ultrapétita
